#define map_width 15
#define map_height 40
static unsigned char map_bits[] = {
   0x00, 0x00, 0x00, 0x00, 0x00, 0x00, 0x00, 0x00, 0x00, 0x00, 0x00, 0x00,
   0x00, 0x00, 0x00, 0x00, 0x00, 0x00, 0x00, 0x00, 0x00, 0x00, 0x00, 0x00,
   0x00, 0x00, 0x00, 0x00, 0x10, 0x02, 0x30, 0x03, 0xd0, 0x02, 0xd0, 0x02,
   0x10, 0x02, 0x10, 0x02, 0x10, 0x02, 0x00, 0x00, 0xc0, 0x00, 0x20, 0x01,
   0x20, 0x01, 0x10, 0x02, 0xf0, 0x03, 0x10, 0x02, 0x10, 0x02, 0x00, 0x00,
   0xf0, 0x01, 0x10, 0x02, 0x10, 0x02, 0x10, 0x02, 0xf0, 0x01, 0x10, 0x00,
   0x10, 0x00, 0x00, 0x00, 0x00, 0x00, 0x00, 0x00};
