#define merlin_width 19
#define merlin_height 40
static unsigned char merlin_bits[] = {
  0x00, 0x00, 0x00, 0x00, 0x02, 0x00, 0x00, 0x02, 0x00, 0x00, 0x05, 0x00,
  0x00, 0x07, 0x00, 0x00, 0x07, 0x00, 0xe0, 0x3f, 0x00, 0x7e, 0xf7, 0x03,
  0xfe, 0xff, 0x03, 0x7e, 0xf7, 0x03, 0x00, 0x07, 0x00, 0x00, 0x07, 0x00,
  0x00, 0x02, 0x00, 0x00, 0x07, 0x00, 0x00, 0x02, 0x00, 0x80, 0x0f, 0x00,
  0x80, 0x0f, 0x00, 0x00, 0x00, 0x00, 0x00, 0x00, 0x00, 0x30, 0x30, 0x00,
  0x60, 0x18, 0x00, 0x60, 0x18, 0x00, 0xa0, 0x14, 0x00, 0xa0, 0x14, 0x00,
  0x20, 0x13, 0x00, 0x20, 0x13, 0x00, 0x20, 0x13, 0x00, 0x70, 0x38, 0x00,
  0x00, 0x00, 0x00, 0xe0, 0x1f, 0x00, 0x40, 0x18, 0x00, 0x40, 0x00, 0x00,
  0x40, 0x04, 0x00, 0xc0, 0x07, 0x00, 0x40, 0x04, 0x00, 0x40, 0x00, 0x00,
  0x40, 0x18, 0x00, 0xe0, 0x1f, 0x00, 0x00, 0x00, 0x00, 0x00, 0x00, 0x00,
  };
