#define n42rf_lf_width 19
#define n42rf_lf_height 40
static unsigned char n42rf_lf_bits[] = {
  0x00, 0x00, 0x00, 0x00, 0x02, 0x00, 0x00, 0x02, 0x00, 0x00, 0x05, 0x00,
  0x00, 0x07, 0x00, 0x00, 0x07, 0x00, 0xe0, 0x3f, 0x00, 0x7e, 0xf7, 0x03,
  0xfe, 0xff, 0x03, 0x7e, 0xf7, 0x03, 0x00, 0x07, 0x00, 0x00, 0x07, 0x00,
  0x00, 0x02, 0x00, 0x00, 0x07, 0x00, 0x00, 0x02, 0x00, 0x80, 0x0f, 0x00,
  0x80, 0x0f, 0x00, 0x00, 0x00, 0x00, 0x00, 0x00, 0x00, 0x00, 0x00, 0x00,
  0xf0, 0xe0, 0x00, 0x20, 0x81, 0x00, 0x20, 0x41, 0x00, 0xe0, 0x8f, 0x00,
  0x20, 0x80, 0x00, 0x70, 0x60, 0x00, 0x00, 0x00, 0x00, 0x00, 0x00, 0x00,
  0x70, 0xf8, 0x00, 0x20, 0x10, 0x00, 0x20, 0x70, 0x00, 0x20, 0x10, 0x00,
  0x20, 0x11, 0x00, 0xf0, 0x39, 0x00, 0x00, 0x00, 0x00, 0x00, 0x00, 0x00,
  0x00, 0x00, 0x00, 0x00, 0x00, 0x00, 0x00, 0x00, 0x00, 0x00, 0x00, 0x00,
  };
