#define radar_rons_width 40
#define radar_rons_height 40
static unsigned char radar_rons_bits[] = {
   0x00, 0x0c, 0x00, 0x00, 0x00, 0x00, 0x0c, 0x00, 0x00, 0x00, 0x00, 0x0c,
   0x00, 0x00, 0x00, 0x00, 0x1c, 0x00, 0x00, 0x00, 0x00, 0x18, 0x00, 0x00,
   0x00, 0x00, 0x18, 0x00, 0x00, 0x00, 0x00, 0x38, 0x00, 0x00, 0x00, 0x00,
   0x38, 0x00, 0x00, 0x00, 0x00, 0x70, 0x00, 0x00, 0x00, 0x00, 0xe0, 0x00,
   0x00, 0x00, 0x00, 0xc0, 0x00, 0x00, 0x00, 0x00, 0xc0, 0x3f, 0x00, 0x00,
   0x00, 0x80, 0x23, 0x00, 0x00, 0x00, 0x00, 0x27, 0x00, 0x00, 0x00, 0x00,
   0x2e, 0x00, 0x00, 0x00, 0x00, 0x3f, 0x00, 0x00, 0x00, 0x00, 0x3f, 0x00,
   0x00, 0x00, 0x00, 0xf7, 0x00, 0x00, 0x00, 0x00, 0xe7, 0x01, 0x00, 0x00,
   0x00, 0x87, 0x07, 0x00, 0x00, 0x00, 0x07, 0x3f, 0x00, 0x00, 0x80, 0x0f,
   0xfc, 0x01, 0x00, 0x80, 0x0f, 0xe0, 0x01, 0x00, 0x80, 0x0f, 0x00, 0x00,
   0x00, 0x80, 0x0f, 0x00, 0x00, 0x00, 0x80, 0x0f, 0x00, 0x00, 0x00, 0xc0,
   0x1f, 0x00, 0x00, 0x00, 0xc0, 0x1f, 0x00, 0x00, 0x00, 0xc0, 0x1f, 0x00,
   0x00, 0x00, 0xc0, 0x1f, 0x00, 0x00, 0x00, 0xc0, 0x1f, 0x00, 0x00, 0x00,
   0x00, 0x00, 0x00, 0x00, 0x1e, 0x13, 0x19, 0xe2, 0x39, 0xa2, 0x34, 0x25,
   0x25, 0x4a, 0xa2, 0x34, 0x0d, 0x25, 0x4a, 0x9e, 0x54, 0x11, 0xe5, 0x49,
   0x92, 0x94, 0xa1, 0x2f, 0x49, 0xa2, 0x94, 0xa5, 0x28, 0x4a, 0x22, 0x13,
   0x99, 0x28, 0x3a, 0x00, 0x00, 0x00, 0x00, 0x00};
