#define radar_nids_width 40
#define radar_nids_height 40
static char radar_nids_bits[] = {
   0x00, 0x00, 0x00, 0x00, 0x00, 0x00, 0x00, 0x00, 0x00, 0x00, 0x00, 0x00,
   0x00, 0x00, 0x00, 0x00, 0x00, 0x00, 0x00, 0x00, 0x00, 0x00, 0x00, 0x40,
   0x04, 0x60, 0x00, 0x00, 0xc0, 0x04, 0x60, 0x00, 0x00, 0xc0, 0x05, 0x60,
   0x00, 0x00, 0x40, 0x07, 0xe0, 0x00, 0x00, 0x40, 0x06, 0xc0, 0x00, 0x00,
   0x40, 0x04, 0xc0, 0x00, 0x00, 0x00, 0x00, 0xc0, 0x01, 0x00, 0x00, 0x01,
   0xc0, 0x01, 0x00, 0x00, 0x01, 0x80, 0x03, 0x00, 0x00, 0x01, 0x00, 0x07,
   0x00, 0x00, 0x01, 0x00, 0x06, 0x00, 0x00, 0x01, 0x00, 0xfe, 0x01, 0x00,
   0x01, 0x00, 0x1c, 0x01, 0x00, 0x00, 0x00, 0x38, 0x01, 0x00, 0x00, 0x00,
   0x70, 0x01, 0xc0, 0x03, 0x00, 0xf8, 0x01, 0x40, 0x04, 0x00, 0xf8, 0x01,
   0x40, 0x04, 0x00, 0xb8, 0x07, 0x40, 0x04, 0x00, 0x38, 0x0f, 0x40, 0x04,
   0x00, 0x38, 0x3c, 0x40, 0x04, 0x00, 0x38, 0xf8, 0xc1, 0x03, 0x00, 0x7c,
   0xe0, 0x0f, 0x00, 0x00, 0x7c, 0x00, 0x0f, 0x00, 0x00, 0x7c, 0x00, 0xc0,
   0x07, 0x00, 0x7c, 0x00, 0x40, 0x00, 0x00, 0x7c, 0x00, 0x40, 0x00, 0x00,
   0xfe, 0x00, 0xc0, 0x07, 0x00, 0xfe, 0x00, 0x00, 0x04, 0x00, 0xfe, 0x00,
   0x00, 0x04, 0x00, 0xfe, 0x00, 0xc0, 0x07, 0x00, 0xfe, 0x00, 0x00, 0x00,
   0x00, 0x00, 0x00, 0x00, 0x00, 0x00, 0x00, 0x00, 0x00, 0x00, 0x00, 0x00,
   0x00, 0x00, 0x00, 0x00, 0x00, 0x00, 0x00, 0x00};
